11111111111111111111111111111111
1000C0C0C0C0C0000111111111111111
10E0C000000000000011111111111111
10000000000C00000000111111111111
10P00000000000000000000000000001
111111100000000C0000000000000001
11111111111111111111111111111111