1111111
1000P11
100CE01
10C0C11
1111111