111111111
10EE01111
10C000111
10P001111
111111111
111111111
111111111
111111111