111111111
10EE01111
10C0P1111
110011111
111111111
111111111
111111111
