111111111
10EE01111
1BC0P1111
110C11111
111111111
111111111
111111111
