111111111
10EEB1111
10C0P1111
110C11111
111111111
111111111
111111111
