11111111111111111111
1E00CC000B0010000001
1000CCB0P00010000001
11111111111111111111