11111111111111111111
1100CC000B0010000001
1100CC000B0010B00B01
1100CC000BB010000001
1100CC000B001B000001
1100CC000B0010B00001
110ECC000B00100B0001
1100CCB0P0001000B001
11111111111111111111