111111111111
10EE01111001
1BC0P1111001
110C111110C1
110C11111001
110C00000001
110C00011001
110C00000001
110C11110001
111111111111
